"filename", "language", "Java", "Markdown", "comment", "blank", "total"
"c:\Users\chemo\Desktop\PRS\PetRescueSagaUI\README.md", "Markdown", 0, 21, 0, 8, 29
"c:\Users\chemo\Desktop\PRS\PetRescueSagaUI\src\App.java", "Java", 16, 0, 0, 6, 22
"c:\Users\chemo\Desktop\PRS\PetRescueSagaUI\src\Controller\MainWindowController.java", "Java", 53, 0, 0, 15, 68
"c:\Users\chemo\Desktop\PRS\PetRescueSagaUI\src\Model\Environnement\Aide.java", "Java", 59, 0, 0, 17, 76
"c:\Users\chemo\Desktop\PRS\PetRescueSagaUI\src\Model\Environnement\Conditions.java", "Java", 21, 0, 3, 7, 31
"c:\Users\chemo\Desktop\PRS\PetRescueSagaUI\src\Model\Environnement\ElementHistorique.java", "Java", 27, 0, 3, 10, 40
"c:\Users\chemo\Desktop\PRS\PetRescueSagaUI\src\Model\Environnement\Jeu.java", "Java", 247, 0, 4, 22, 273
"c:\Users\chemo\Desktop\PRS\PetRescueSagaUI\src\Model\Environnement\Joueur.java", "Java", 63, 0, 3, 17, 83
"c:\Users\chemo\Desktop\PRS\PetRescueSagaUI\src\Model\Environnement\Niveau.java", "Java", 45, 0, 4, 11, 60
"c:\Users\chemo\Desktop\PRS\PetRescueSagaUI\src\Model\Environnement\Partie.java", "Java", 181, 0, 13, 41, 235
"c:\Users\chemo\Desktop\PRS\PetRescueSagaUI\src\Model\Environnement\Plateau.java", "Java", 454, 0, 27, 41, 522
"c:\Users\chemo\Desktop\PRS\PetRescueSagaUI\src\Model\Environnement\UserNotFound.java", "Java", 9, 0, 4, 5, 18
"c:\Users\chemo\Desktop\PRS\PetRescueSagaUI\src\Model\Movible\Animal.java", "Java", 24, 0, 6, 6, 36
"c:\Users\chemo\Desktop\PRS\PetRescueSagaUI\src\Model\Movible\Brique.java", "Java", 22, 0, 3, 7, 32
"c:\Users\chemo\Desktop\PRS\PetRescueSagaUI\src\Model\Movible\Case.java", "Java", 55, 0, 3, 18, 76
"c:\Users\chemo\Desktop\PRS\PetRescueSagaUI\src\Model\Movible\Couleur.java", "Java", 31, 0, 0, 9, 40
"c:\Users\chemo\Desktop\PRS\PetRescueSagaUI\src\Model\Movible\Element.java", "Java", 12, 0, 4, 6, 22
"c:\Users\chemo\Desktop\PRS\PetRescueSagaUI\src\Model\Movible\Obstacle.java", "Java", 20, 0, 4, 7, 31
"c:\Users\chemo\Desktop\PRS\PetRescueSagaUI\src\View\AidePanel.java", "Java", 42, 0, 3, 9, 54
"c:\Users\chemo\Desktop\PRS\PetRescueSagaUI\src\View\AnimalView.java", "Java", 26, 0, 3, 7, 36
"c:\Users\chemo\Desktop\PRS\PetRescueSagaUI\src\View\AudioGame.java", "Java", 47, 0, 7, 18, 72
"c:\Users\chemo\Desktop\PRS\PetRescueSagaUI\src\View\ComponentView.java", "Java", 10, 0, 3, 6, 19
"c:\Users\chemo\Desktop\PRS\PetRescueSagaUI\src\View\ConnexionView.java", "Java", 49, 0, 11, 16, 76
"c:\Users\chemo\Desktop\PRS\PetRescueSagaUI\src\View\EmptyBlockView.java", "Java", 15, 0, 3, 7, 25
"c:\Users\chemo\Desktop\PRS\PetRescueSagaUI\src\View\GamePane.java", "Java", 139, 0, 26, 49, 214
"c:\Users\chemo\Desktop\PRS\PetRescueSagaUI\src\View\HistoriqueView.java", "Java", 47, 0, 10, 15, 72
"c:\Users\chemo\Desktop\PRS\PetRescueSagaUI\src\View\InscriptionView.java", "Java", 59, 0, 11, 20, 90
"c:\Users\chemo\Desktop\PRS\PetRescueSagaUI\src\View\MainWindow.java", "Java", 147, 0, 22, 54, 223
"c:\Users\chemo\Desktop\PRS\PetRescueSagaUI\src\View\MenuJeu.java", "Java", 63, 0, 13, 19, 95
"c:\Users\chemo\Desktop\PRS\PetRescueSagaUI\src\View\ObstacleView.java", "Java", 32, 0, 5, 14, 51
"c:\Users\chemo\Desktop\PRS\PetRescueSagaUI\src\View\PlateauPanel.java", "Java", 154, 0, 32, 44, 230
"c:\Users\chemo\Desktop\PRS\PetRescueSagaUI\src\View\View.java", "Java", 12, 0, 3, 5, 20
"Total", "-", 2181, 21, 233, 536, 2971